***********************
*         *       * *E*
*    ******  ***  *   *
** * *    *  * ***** **
*  * * *  *  *        *
* ** * *  *  * * ******
*S *   *       *      *
***********************
